+---+---+---+---+---+
|       |           |
+   +   +---+---+   +
|   |   |   |       |
+   +   +-o-+   +-o-+
|   |       |   |   |
+   +---+---+   +---+
|   |               |
+   +---+---+---+   +
|                   |
+---+---+---+---+---+