╭───────┬───────────╮
│       │           │
│   ╶───╯   ╭───╴   │
│           │       │
├───────────┤   ╭───┤
│           │   │   │
│   ╭───────╯   ├─o─┤
│   │           │   │
│   ╵   ╶───────╯   │
│                   │
╰───────────────────╯