+---+---+---+---+---+---+---+---+---+---+
|               |       |               |
+-o-+---+---+   +   +   +---+---+---+   +
|   |       |   |   |           |       |
+---+   +   +   +-o-+---+---+   +   +   +
|       |       |   |       |       |   |
+   +   +---+---+---+---+   +---+---+   +
|   |   |       |           |           |
+   +   +   +   +   +   +---+   +---+---+
|   |   |   |       |       |           |
+   +   +   +---+---+---+   +---+---+   +
|   |   |               |           |   |
+   +   +---+---+---+   +---+   +---+   +
|   |               |       |       |   |
+   +---+---+---+---+---+   +---+   +   +
|   |       |               |   |   |   |
+   +   +   +   +---+---+---+-o-+   +   +
|   |   |   |               |   |   |   |
+   +   +   +---+---+---+   +   +   +   +
|       |                       |       |
+---+---+---+---+---+---+---+---+---+---+